W W W W W W W W W W W W G G W W W W W W W W W W W
W W W W W W W W W W W W G G W W W W W W W W W W W
W W W W W W W W W W W W G G W W W W W W W W W W W
W W W W W W W W L L L L G G L L L L W W W W W W W
W W W W W W W W L L L L G G L L L L W W W W W W W
W W W W W W W W L L G G G G G G L L W W W W W W W
W W W W W W W W L L G G G G G G L L W W W W W W W
W W W W W W W W L L G G G G G G L L W W W W W W W
G G G G G G G G G G G G G G G G G G G G G G G G G
G G G G G G G G G G G G G G G G G G G G G G G G G
W W W W W W W W B B G G G G G G B B W W W W W W W
W W W W W W W W B B G G G G G G B B W W W W W W W
W W W W W W W W B B G G G G G G B B W W W W W W W
W W W W W W W W B B B B G G B B B B W W W W W W W
W W W W W W W W B B B B G G B B B B W W W W W W W
W W W W W W W W W W W W G G W W W W W W W W W W W
W W W W W W W W W W W W G G W W W W W W W W W W W
W W W W W W W W W W W W G G W W W W W W W W W W W
W W W W W W W W W W W W G G W W W W W W W W W W W
