W L W W W W W W W W W W W W W W W W W W W W W W W
L L L L L L L L L L L L L L L L L L L L W W W W W
G G G G G G G G G G G G G G G G G G G G W W W W W
W W W W W W W B G G G G G G B W W W W W W W W W W
L L L L L L L B G G G G G G B L L L L L W W W W W
G G G G G G G B G G G G G G B G G G G G W W W W W
W W W W W W W B G G G G G G B W W W W W W W W W W
L L L L L L L B G G G G G G B L L L L L W W W W W
G G G G G G G B G G G G G G B G G G G G W W W W W
W W W W W W W B G G G G G G B W W W W W W W W W W
L L L L L L L B G G G G G G B L L L L L W W W W W
G G G G G G G B G G G G G G B G G G G G W W W W W
W W W W W W W W W W W W W W W W W W W W W W W W W
L L L L L L L L L L L L L L L L L L L L W W W W W
G G G G G G G G G G G G G G G G G G G G W W W W W
B B B B B B B B B B B B W W W W W G G G L L L L L
B B B B B B B B B B B B W W W W W G G G L L L L L
B B B B B B B B B B B B W W W W W G G G L L L L L
B B B B B B B B B B B B W W W W W G G G L L L L L