L B B B B B B B B B B B B B B B B B B B B B B B L
L L L L L L L L L W W W W L L L L L L L L L L L L
L L L L L L L L L W W W W L L L L L L L L L L L L
B B B B B B B B L W W W W L B B B B B B B B B B B
B B W W W W B B L W W W W L B B W W W W W W B B B
B W B W W B W B L W W W W L B W B W W W W B W B B
B W W B B W W B L W W W W L B W W B B B B W W B B
B B B B B B B B L W W W W L B B B B B B B B B B B
L L L L L L L L L G G G G L L L L L L L L L L L L
B W B W B W B B G G G G G G B B W B W B W B W B W
W B W B W B W B G G G G G G B W B W B W B W B W B
L L L L L L L L L G G G G L L L L L L L L L L L L
B B B B B B B B L W W W W L B B B B B B B B B B B
B B W W W W B B L W W W W L B B W W W W W W W B B
B W B W W B W B L G G G G L B W B W W W W W B W B
B B B B B B B B L G B B G L B B B B B B B B B B B
L L L L L L L L L B B B B L L L L L L L L L L L L
B B B B B B B B B B B B B B B B B B B B B B B B B
B B B B B B B B B B B B B B B B B B B B B B B B B